######################*#################
#.......#.....#...........#.......#...##
#.#.###.###.#.#########.#.#######.#.#.##
#.#.#.#...#.#.......#...#.....#...#.#.##
#.#.#.###.#.#######.#.#######.#.###.#.##
#.#.#...#...#.....#...#.....#.#...o.#.##
###.#.#.#####.#.###.#####.###.#####.#.##
#...#.#.....#.#.....#...#...#.o...#.#.##
#.#####.###.#.#######.#.#.#.#####.#.#.##
#.....#.#...#.#.#.....#.#.#.......#.#.##
#.###.#.#####.#.#.#####.#.###########.##
#.#...#.........#.#...#.#...#.........##
*##.###.#########.#.#.#.###.###.###.#.#*
#...#.......#.......#.#...#...#...#.#.##
#o#####.#####.###########.###.#####.####
#.#...#.#.......#.......#...#.....#...##
#.#.#.###.#######.#####.###.#####.#.#.##
#.#.#...#.....#...#.#...#...#.....#.#.##
#.#.###.#####.#.###.#.###.###.#######.##
#...#.#.....#.#.....#.#.....#.#.......##
#.###.#####.#.#####.#.#.###.#.#.#####.##
#...#.#.....#...#.#.#.#.#.#.#...#.#...##
###.#.#.###.###.#.#.###.#o#.#####.#.####
#.#...#.#.....#...#...#...#.#.....#.#.##
#.#.###.#.#######.###.#####.#.#.###.#.##
#.#.#...#...#...#.#.#...#...#.#.#...#.##
#.#.#.#######.#.#.#.###.#.###.#.#.###.##
#...#.........#.......#...#...#.......##
########################################
######################*#################
