######################*#################
#...#.........#.........#.......#.....##
#.#.#.#####.#.#.#.#####.###.###.#.###.##
#.#...#...#.#.#.#.#...#.....#.#...#...##
#.#####.###.###.#.#.#.#######.#####.####
#.......#...#...#.#.#.#.....#.....#...##
#######.#.###.###.#.#.#####o#.###.###.##
#...o.#.#.....#.#...#.....#.....#.#...##
#.###.#.#######.#########.#####.#.#.####
#...#.#.#.........#.....#.....#.#...#.##
*##.#.#.###.#####.#.#.#######.#.#####.#*
#.#.#.#.....#...#.#.#.......#.#.....#.##
#.#.#.#######.###.#######.###.#####.#.##
#...#.....#.......#.......#...#...#.#.##
#######.#.#.#######.#######.###.#.#.#.##
#...#...#.#.#.#.........#...#...#.#...##
#.#.#.###.#.#o#.#######.#.###.###.###.##
#.#...#...#.#.......#.#.#.......#...#.##
#.#########.#######.#.#o###########.#.##
#.........#.......#...#.....#...#...#.##
#.#######.#######.###.#####.#.#.#.######
#.#.....#.........#.#.#.....#.#.#.....##
#.#.#.#############.#.#.#####.#.#.###.##
#.#.#.........#.#.....#...#...#.#...#.##
#.#######.###.#.#.#######.#.###.###.#.##
#...#.....#.#.#.....#...#.#.#.#.#...#.##
###.#.#####.#.#######.#.#.###.#.#####.##
#.....#...............#.......#.......##
########################################
######################*#################
