###*################
#.....o...#..o..#.##
#.#########.#.#.#.##
#...........#.#...##
#.###########.###.##
#.....#o..#...#.#.##
#####.#.#.#.###.#.##
#.......#.#.#.o...##
*##########.#######*
###*#######.########
