###################
#........#........#
#.##.###.#.###.##.#
#o##.###.#.###.##o#
#.................#
#.##.#.#####.#.##.#
#....#...#...#....#
####.### # ###.####
*   . B p I C     *
####.# ##### #.####
#........P........#
####.# ##### #.####
   #.#       #.#
####.# ##### #.####
#.................#
#.##.###.#.###.##.#
#o..#.....#.....#o#
##.#.#.#####.#.#.##
#....#...#...#....#
#.######.#.######.#
#.................#
###################
